# Map file for tile-based game
# (Lines that start with '#' are comments)
# The tiles are:
#   (Space) Empty tile
#   A..Z    Tiles A through Z
#   o       Star
#   !       Music Note
#   *       Goal
#   1       Bad Guy 1 (grub)
#   2       Bad Guy 2 (fly)
                                                                 
AD                                                           o     o   CA
AD                                                     o      o    o   CA
AD                       o o o        o o o       o     o      o       CA
AD                      IIIIIII      IIIIIII       o     o         2   CA
AD                                                  o        2         CA
AD                                  2                 2EF              CA
AD                 EF                                 EGD              CA
AD        EF  1    CD       1           1            EGAD     *        CA
ADBBBBBBBBGHBBBBBBBGHBBBBBBBBBBBBBBBBBBBBBBBBBBBBBBBBGAAHBBBBBBBBBBBBBBCA
